"filename", "language", "vue", "TypeScript", "JavaScript", "Less", "comment", "blank", "total"
"d:\vscode\pj\re-project\src\App.vue", "vue", 35, 0, 0, 0, 0, 3, 38
"d:\vscode\pj\re-project\src\api\config.ts", "TypeScript", 0, 24, 0, 0, 63, 3, 90
"d:\vscode\pj\re-project\src\api\request.ts", "TypeScript", 0, 10, 0, 0, 0, 6, 16
"d:\vscode\pj\re-project\src\components\Advertisement.vue", "vue", 56, 0, 0, 0, 0, 12, 68
"d:\vscode\pj\re-project\src\components\Header\MiddleTopHeader.vue", "vue", 147, 0, 0, 0, 0, 7, 154
"d:\vscode\pj\re-project\src\components\Header\MiniMiddleHeader.vue", "vue", 68, 0, 0, 0, 0, 7, 75
"d:\vscode\pj\re-project\src\components\IconButton.vue", "vue", 42, 0, 0, 0, 0, 3, 45
"d:\vscode\pj\re-project\src\components\Loading.vue", "vue", 13, 0, 0, 0, 0, 1, 14
"d:\vscode\pj\re-project\src\components\Logo.vue", "vue", 103, 0, 0, 0, 0, 5, 108
"d:\vscode\pj\re-project\src\components\MessageItem.vue", "vue", 123, 0, 0, 0, 0, 12, 135
"d:\vscode\pj\re-project\src\components\Messager.vue", "vue", 66, 0, 0, 0, 0, 5, 71
"d:\vscode\pj\re-project\src\components\NotificationContent.vue", "vue", 72, 0, 0, 0, 3, 3, 78
"d:\vscode\pj\re-project\src\components\Post.vue", "vue", 365, 0, 0, 0, 3, 31, 399
"d:\vscode\pj\re-project\src\components\Publish.vue", "vue", 193, 0, 0, 0, 0, 22, 215
"d:\vscode\pj\re-project\src\components\Setting\SettingDetailItem.vue", "vue", 52, 0, 0, 0, 0, 1, 53
"d:\vscode\pj\re-project\src\components\Setting\SettingItem.vue", "vue", 40, 0, 0, 0, 0, 3, 43
"d:\vscode\pj\re-project\src\components\Skeleton\HomeSkeleton.vue", "vue", 142, 0, 0, 0, 0, 11, 153
"d:\vscode\pj\re-project\src\components\TabBar.vue", "vue", 81, 0, 0, 0, 0, 3, 84
"d:\vscode\pj\re-project\src\components\TopBarSetting\Mark.vue", "vue", 24, 0, 0, 0, 0, 1, 25
"d:\vscode\pj\re-project\src\components\VirtualList\DynamicHeightVirtualList.vue", "vue", 490, 0, 0, 0, 0, 87, 577
"d:\vscode\pj\re-project\src\components\VirtualList\FixedHeightVirtualList.vue", "vue", 365, 0, 0, 0, 0, 47, 412
"d:\vscode\pj\re-project\src\components\VirtualList\ListItem.vue", "vue", 65, 0, 0, 0, 0, 9, 74
"d:\vscode\pj\re-project\src\components\VirtualList\VirtualList.vue", "vue", 123, 0, 0, 0, 0, 12, 135
"d:\vscode\pj\re-project\src\components\VirtualList\index.vue", "vue", 42, 0, 0, 0, 0, 4, 46
"d:\vscode\pj\re-project\src\constant\InputHeight.js", "JavaScript", 0, 0, 6, 0, 1, 2, 9
"d:\vscode\pj\re-project\src\constant\chat.js", "JavaScript", 0, 0, 12, 0, 15, 6, 33
"d:\vscode\pj\re-project\src\constant\publish.js", "JavaScript", 0, 0, 16, 0, 3, 5, 24
"d:\vscode\pj\re-project\src\constant\style.js", "JavaScript", 0, 0, 13, 0, 1, 2, 16
"d:\vscode\pj\re-project\src\constant\table.js", "JavaScript", 0, 0, 5, 0, 1, 2, 8
"d:\vscode\pj\re-project\src\hooks\useState.ts", "TypeScript", 0, 9, 0, 0, 0, 10, 19
"d:\vscode\pj\re-project\src\main.ts", "TypeScript", 0, 14, 0, 0, 3, 1, 18
"d:\vscode\pj\re-project\src\pages\Home\Home.vue", "vue", 175, 0, 0, 0, 1, 20, 196
"d:\vscode\pj\re-project\src\pages\Home\RightBar.vue", "vue", 151, 0, 0, 0, 0, 16, 167
"d:\vscode\pj\re-project\src\pages\Login.vue", "vue", 433, 0, 0, 0, 0, 51, 484
"d:\vscode\pj\re-project\src\pages\Mark.vue", "vue", 124, 0, 0, 0, 0, 11, 135
"d:\vscode\pj\re-project\src\pages\Message.vue", "vue", 200, 0, 0, 0, 0, 24, 224
"d:\vscode\pj\re-project\src\pages\MessageContent.vue", "vue", 122, 0, 0, 0, 0, 14, 136
"d:\vscode\pj\re-project\src\pages\More.vue", "vue", 13, 0, 0, 0, 0, 1, 14
"d:\vscode\pj\re-project\src\pages\Notification.vue", "vue", 107, 0, 0, 0, 0, 16, 123
"d:\vscode\pj\re-project\src\pages\PersonProfile.vue", "vue", 148, 0, 0, 0, 0, 18, 166
"d:\vscode\pj\re-project\src\pages\PostDetail.vue", "vue", 190, 0, 0, 0, 0, 13, 203
"d:\vscode\pj\re-project\src\pages\Profile.vue", "vue", 119, 0, 0, 0, 0, 6, 125
"d:\vscode\pj\re-project\src\pages\Setting.vue", "vue", 65, 0, 0, 0, 0, 2, 67
"d:\vscode\pj\re-project\src\pages\SettingDetail.vue", "vue", 70, 0, 0, 0, 0, 1, 71
"d:\vscode\pj\re-project\src\registerServiceWorker.ts", "TypeScript", 0, 31, 0, 0, 1, 3, 35
"d:\vscode\pj\re-project\src\router\index.ts", "TypeScript", 0, 107, 0, 0, 2, 8, 117
"d:\vscode\pj\re-project\src\service\user.ts", "TypeScript", 0, 8, 0, 0, 0, 3, 11
"d:\vscode\pj\re-project\src\shims-vue.d.ts", "TypeScript", 0, 5, 0, 0, 1, 1, 7
"d:\vscode\pj\re-project\src\store\user.ts", "TypeScript", 0, 13, 0, 0, 14, 3, 30
"d:\vscode\pj\re-project\src\types\Dynamic.ts", "TypeScript", 0, 18, 0, 0, 27, 6, 51
"d:\vscode\pj\re-project\src\types\Element.ts", "TypeScript", 0, 2, 0, 0, 0, 2, 4
"d:\vscode\pj\re-project\src\types\Fixed.ts", "TypeScript", 0, 18, 0, 0, 27, 6, 51
"d:\vscode\pj\re-project\src\types\chat.ts", "TypeScript", 0, 26, 0, 0, 0, 3, 29
"d:\vscode\pj\re-project\src\types\post.ts", "TypeScript", 0, 17, 0, 0, 6, 2, 25
"d:\vscode\pj\re-project\src\types\user.ts", "TypeScript", 0, 14, 0, 0, 3, 1, 18
"d:\vscode\pj\re-project\src\types\virtualList.ts", "TypeScript", 0, 39, 0, 0, 27, 10, 76
"d:\vscode\pj\re-project\src\utils\Date.ts", "TypeScript", 0, 22, 0, 0, 10, 6, 38
"d:\vscode\pj\re-project\src\utils\Equipment.ts", "TypeScript", 0, 33, 0, 0, 1, 9, 43
"d:\vscode\pj\re-project\src\utils\FakePost.ts", "TypeScript", 0, 29, 0, 0, 0, 3, 32
"d:\vscode\pj\re-project\src\utils\Num.ts", "TypeScript", 0, 6, 0, 0, 0, 2, 8
"d:\vscode\pj\re-project\src\utils\Style.ts", "TypeScript", 0, 21, 0, 0, 6, 6, 33
"d:\vscode\pj\re-project\src\utils\localStorage.ts", "TypeScript", 0, 64, 0, 0, 6, 14, 84
"d:\vscode\pj\re-project\src\utils\requestTransform.ts", "TypeScript", 0, 16, 0, 0, 0, 2, 18
"d:\vscode\pj\re-project\src\utils\uuid.ts", "TypeScript", 0, 12, 0, 0, 0, 0, 12
"d:\vscode\pj\re-project\src\var.less", "Less", 0, 0, 0, 8, 0, 10, 18
"d:\vscode\pj\re-project\src\views\BottomBar.vue", "vue", 111, 0, 0, 0, 1, 5, 117
"d:\vscode\pj\re-project\src\views\LeftBar.vue", "vue", 271, 0, 0, 0, 0, 23, 294
"d:\vscode\pj\re-project\src\views\MainContent.vue", "vue", 18, 0, 0, 0, 0, 1, 19
"d:\vscode\pj\re-project\src\views\MidBar.vue", "vue", 47, 0, 0, 0, 0, 10, 57
"d:\vscode\pj\re-project\src\vuex.d.ts", "TypeScript", 0, 6, 0, 0, 16, 3, 25
"Total", "-", 5071, 564, 52, 8, 242, 661, 6598